####A####
##     ##
## ### ##
#   #   #
#B# # # #